you mean what => what do you mean?
you have questions? => do you have any questions?
why? => why?
who? => who?
where? => where?
when? => when?
how ?=> how?
which? => which?
again. what? => can you repeat that?
you can repeat => can you repeat that?
you understand? => do you understand me?
i not understand => i don’t understand
clear? => is that clear?
hello => hello
good morning => good morning
good afternoon => good afternoon
good evening => good evening
good night => good night
you how? => how are you
i’m fine => i’m fine
nice meet you => it’s nice to meet you
long time, see none => i haven’t seen you in a while
take care => take care
welcome (greeting) => welcome
have nice day => have a nice day
you name what? => what is your name?
my name (finger-spell) => my name is (finger-spelled)
you house where? => where do you live?
i live manila => i live in manila
you hearing / deaf => are you hearing or deaf
i deaf => i am deaf
i hearing => i am hearing
you house where? / from where? => where are you from
i from cebu => i am from cebu
you sign name what? => what is your sign name
i school person => i am a student
nice communicate (with you) => it’s nice talking with you
time wake what? => what time do you wake up
eat breakfast => i eat breakfast
lunch time => it’s lunchtime
eat dinner => i eat dinner
go work => i am going to work
go school => i am going to school
work finish => i have finished work
now time sleep => it’s time to sleep
have pay  => i have to pay
watch tv => i’m watching tv
clean house => i’m cleaning the house
i happy => i am happy
i sad => i am sad
i excited => i am excited
i angry => i am angry
i bored => i am bored
i confused => i am confused
i worried => i am worried
i surprised => i am surprised
i proud => i am proud
i embarrassed => i am embarrassed
you need help => do you need help
need help me => i need help
please help me => please help me
you please help me / you help me can => could you help me
excuse me => excuse me
sorry pass => excuse me (passing by)
thank you => thank you
you want water? => do you want water
more => i want more
please wait => please wait
sign slow please => please sign more slowly
don’t mind => never mind
repeat please => please repeat that
father => father
mother => mother
parents => parents
brother => brother
sister => sister
sibling => sibling
son => son
daughter => daughter
child (kids) => child
husband => husband
wife => wife
you have children? => do you have children
i have two children => i have two children
single => i am single
married => i am married
separated => i am separated
boyfriend => boyfriend
girlfriend => girlfriend
family many => my family is large
family small => my family is small
family visit saturday sunday => i will visit my family this weekend
CR where => where is the bathroom
entrance where => where is the entrance
exit where => where is the exit
office where? => where is the office located
turn left => turn left
turn right => turn right
straight ahead => go straight ahead
upstairs => go upstairs
downstairs => go downstairs
far or near => is it far or near
you know place? => do you know this place
now => right now
today => today
tomorrow => tomorrow
yesterday => yesterday
next week => next week
last week => last week
now time what? => what time is it
meeting when? time start what => what time is the meeting
time finish what? => what time does it end
time start what? => what time does it start
class start => class is starting
class finish => class has finished
i learn sign language => i am studying sign language
teacher explain again => the teacher will explain again
i pass test => i passed the test
i fail test => i failed the test
group study want join => do you want to join a study group
i absent yesterday => i was absent yesterday
i work where => where do i work
i work office => i work in an office
i busy => i am busy
now meeting start => the meeting is starting
meeting finish => the meeting has ended
boss call you => the boss wants to see you
need approve document => i need to get this document approved
let’s schedule meeting => let’s schedule a meeting
lunch break time => it’s time for lunch break
happen what? => what happened
congratulations => congratulations
good luck => good luck
same here => me too
me too => me too
i agree => i agree
i disagree => i disagree
be careful => be careful
don’t worry => don’t worry
depends on you => it’s up to you
really => really
seriously => seriously
wow => wow
wow => that’s amazing
that interesting => that is interesting
tomorrow, see you => i’ll see you tomorrow
fine => no problem
can => i can
cannot => i cannot
wait a moment => wait a moment
again. you name what? => could you tell me your name again
you work where? => where do you work
your age what => how old are you
i age 20 => i am 20 years old
i volunteer => i volunteer
you want coffee? => would you like coffee
please sit => please take a seat
please stand up => please stand up
open door => open the door
close door => close the door
turn on light => turn on the light
turn off light => turn off the light
sign slow => sign slowly
you sign name => what is your sign name
pronounce how => how do you pronounce that
finger-spell again => please finger-spell that again
learning continue => i’m still learning
easy or hard => is it easy or hard
need practice more => i need more practice
don’t forget => don’t forget
notice me => did you notice me
please answer => please answer
good job => good job
move forward => move forward
step back => step back
sorry => i’m sorry
thank you again => thank you again
explain more => explain more
stop => stop
continue => continue
have advice? => do you have any advice
i try => i’ll try
enjoy => enjoy
fine => that’s fine
hurry => hurry up
relax => relax
take your time => take your time
stay calm => stay calm
forget it => forget it
of course => of course
finish => done
later talk => let’s talk later
you practice sign => are you practicing sign
let’s practice => let’s practice
thumbs up => good job
you feel pain => do you feel pain?
have infection => i have an infection
arm hurt => arm hurts
buy medicine where? => where is the pharmacy?
doctor check you => the doctor will check you
need x-ray => i need an x-ray
call ambulance now => call an ambulance now
are you allergic => are you allergic?
nurse come soon => the nurse will come soon
diagnosis not understand => i don’t understand the diagnosis
discharge me why? => why am i being discharged?
medicine take daily => take this medicine daily
you have fever => do you have a fever?
please measure bloodpressure => please measure my blood pressure
appointment tomorrow => my appointment is set for tomorrow
lab test results => the lab test results are here
you have chills? => do you have chills?
my leg swelling => my leg is swelling
she has backpain => she has back pain
need followup checkup => i need a follow-up checkup
hospital where? => where is the hospital?
i want second opinion => i want a second opinion
stitches remove when => when will the stitches be removed?
take antibiotic => take the antibiotic
any allergies? => do you have any allergies?
pain feel what? scale 1-10 => rate your pain on a scale of 1-10
you breathe can? fine? => can you breathe okay?
diagnosis explain again => please explain the diagnosis again
insurance cover cost => does insurance cover the cost?
i need referral => i need a referral
test for cancer => i need a test for cancer
Clinic where? => where is the clinic?
Have schedule for surgery => the surgery is scheduled
scan chest => i need a chest scan
have/feel joint pain? => do you have joint pain?
extremity numb => my extremity is numb
doctor does ultrasound => the doctor will do an ultrasound
injury serious => is the injury serious?
patient rest => the patient should rest
monitor vital signs => monitor your vital signs
instructions obey => follow these instructions
take sedative => take the sedative
any side effects => are there any side effects?
need blood sample => they need a blood sample
wound clean => please clean the wound
test negative => the test came back negative
ambulance arrive => the ambulance will arrive soon
heartbeat irregular => my heartbeat is irregular
discomfort chest => i have chest discomfort
use crutches => use the crutches
feel dizzy you => do you feel dizzy?
you cough why? => why are you coughing?
infection serious => is the infection serious?
fever or chills => do you have a fever or chills?
flu vaccine want => do you want a flu vaccine?
bandage where? => where is the bandage?
Please diagnose me => please diagnose me
Worry have dehydration=> i'm worried about dehydration
headache strong => my headache is strong
prescription refill => i need a prescription refill
take vitamin => take your vitamins
painkiller help? => does the painkiller help?
monitor bloodpressure daily => monitor your blood pressure daily
clinic open when => when does the clinic open?
emergency room => go to the emergency room
medication dosage => what is the medication dosage?
backpain continue => my back pain is continuing
surgeon ready => the surgeon is ready
anxiety high => my anxiety is high
Need you explain more => i need more explanation
adjust medication => adjust your medication
careful wound => be careful with the wound
chestpain radiate => does the chest pain radiate?
take antibiotic daily => take the antibiotic daily
any risk surgery => are there any risks with this surgery?
urgent help => i urgently need help
disinfect cut => disinfect the cut
lab results normal => the lab results are normal
hernia diagnosis => do i have a hernia diagnosis?
Need Medication for acne => i need acne medication
she pregnant => she is pregnant
exercise recommended => exercise is recommended
rest required => you are required to rest
Heartbeat fast, not normal => my heartbeat is rapid
burn wound => i have a burn wound
he unconscious => he is unconscious
any improvement => is there any improvement?
recovery long? => will recovery be long?
examine wrist => examine my wrist
temporary cast => put on a temporary cast
inflammation severe => the inflammation is severe
pain relief => i need pain relief
avoid infection => avoid infection
minor fracture => it's a minor fracture
lost appetite => i have lost my appetite
specialist referral => i need a referral to a specialist
child sick => my child is sick
temperature monitor => monitor your temperature
instructions understand? => do you understand the instructions?
my head bleed => my head is bleeding
maybe have arm fracture => i might have a fractured arm
You feel numb can? => can you feel numbness?
next checkup when => when is my next checkup?
heart condition => i have a heart condition
You recover, we monitor => we will monitor your recovery
cold or flu? => is it a cold or the flu?
my leg infection => i have an infection in my leg
cut deep => the cut is deep
Heal time pila? => how long will it take to heal?
nausea stop? => has your nausea stopped?
why high fever => why is my fever high?
take medication soon => take your medication soon
my doctor refer specialist => my doctor referred me to a specialist
i need chest x-ray => i need a chest x-ray
hurt when breathe => it hurts when i bcreathe
injection where? => where is my injection site?
absorb dosage properly => are you absorbing the dosage properly?
she have operation schedule => she scheduled an operation
nurse who? => who is my nurse?
pain in abdomen => i have pain in my abdomen
family worried => my family is worried
doctor does procedure => the doctor will do the procedure
any dizziness => are you experiencing any dizziness?
he complain headache => he complains of a headache
important instructions obey => follow the instructions carefully
need your blood sample => i need your blood sample
risk infection => there is a risk of infection
why feeling faint => why am i feeling faint?
medicine take when? => how often should i take the dosage?
swallow pill => swallow the pill
eye exam needed => an eye exam is needed
patient discharge soon => the patient will be discharged soon
shortness breath => i have shortness of breath
flulike symptoms => i have flu-like symptoms
does pain travel => does the pain travel anywhere else?
monitor heartattack risk => monitor for heart attack risk
pressure in chest => i feel pressure in my chest
surgery finish, need stitches => you will need stitches after surgery
treatment plan ready => the treatment plan is ready
wound clean daily => clean the wound daily
take rest often => please take rest often
she might dehydrated => she might be dehydrated
do i need sedation => do i need sedation?
backpain why? => why am i having back pain?
call nurse help => call the nurse for help
monitor improvement daily => monitor for daily improvement
doctor advice bed rest => the doctor advised bed rest
any difficulty swallow => any difficulty swallowing?
nurse check vitals => the nurse will check your vitals
ambulance call => can someone call an ambulance?
ambulance arrive => the ambulance has arrived
emergency happen => there is an emergency
paramedic come => the paramedic is coming
accident happen => there was an accident
stretcher need => we need a stretcher
sirens loud => the sirens are loud
oxygen please => we need oxygen
driver hurry => the driver should hurry
shock patient => the patient is in shock
monitor vital signs => please monitor the vital signs
patient stable => the patient is stable now
defibrillator ready => have the defibrillator ready
urgent transport => we need an urgent transport
dispatch center call => call the dispatch center
trauma care => provide trauma care
someone unconscious => someone is unconscious
first aid => i will give first aid
patient resuscitate => we need to resuscitate the patient
she/he hospital transport => we will transport the patient to the hospital
someone bleeding => the person is bleeding
someone not breathing => the person is not breathing
someone choking => the person is choking
driver watch road => driver, please watch the road
soon arrive => we will arrive soon
monitor patient => please monitor the patient carefully
someone panic => the person is panicking
someone collapsed => the person has collapsed
carefully handle => handle them carefully
neck stabilize => please stabilize their neck
stretcher load => please load the stretcher
seatbelt secure => please secure your seatbelt
call doctor => call the doctor
need immediate care => the patient needs immediate care
paramedic check => the paramedic will check you
Please calm => please stay calm
you feel pain? => do you feel any pain?
disinfect wound => let's disinfect the wound a
bandage apply => let's apply a bandage
We going => we are on our way
